{
    "meta": {
        "size": { "w": 10, "h": 10 }
    },
    "fields": [
        [ 0, 0, 0, 0, 0, 0, 0, 0, 0, 0 ],
        [ 0, 0, 0, 1, 0, 1, 1, 1, 1, 0 ],
        [ 0, 0, 1, 1, 1, 1, 0, 0, 1, 0 ],
        [ 0, 0, 0, 1, 0, 0, 0, 0, 1, 0 ],
        [ 0, 0, 0, 0, 0, 0, 1, 0, 1, 0 ],
        [ 0, 0, 0, 0, 0, 0, 1, 0, 1, 0 ],
        [ 0, 0, 0, 0, 0, 1, 1, 1, 1, 0 ],
        [ 0, 0, 0, 0, 0, 1, 0, 0, 0, 0 ],
        [ 0, 1, 1, 1, 1, 1, 0, 0, 0, 0 ],
        [ 0, 0, 0, 0, 0, 0, 0, 0, 0, 0 ]
    ]
}